NO ./imgs/northWall.xpm
SO ./imgs/southWall.xpm
WE ./imgs/westWall.xpm
EA ./imgs/eastWall.xpm

F 176,216,230
C 53,228,234

		1111111111111111111111111
		10000000001100000000N0101
		1011000001110000000000001
		1001000000000000000000001
111111111011000001110000000000001
100000000011000001110111111111111
11110111111111011100000010001
11110111111111011101010010001
11000000110101011100000010001
10000001 100000001100000010001
10000000100000001101010000001
1100000111010101111101111000111
11110111 1110101 101111010001
11111111 1111111 111111111111
