NO ./imgs/northWall.xpm
SO ./imgs/southWall.xpm
WE ./imgs/westWall.xpm
EA ./imgs/eastWall.xpm

F 176,216,230
C 53,228,234

		1111111111111111111111111
		10000000001100000000S0101
		1011000001110000000000001
		10010000000000000000D0001
111111111011000001110000000000001
100V00000011000001110111111111111
11110111111111011100000010001
11110111111111011101010010001
11000000110101011100000010001
10000001 100U00001100000010001
100000001000000011010100D0001
1100000111010101111101111000111
11110111 1110101 101111010001
11111111 1111111 111111111111
