NO ./imgs/northWall.xpm
SO ./imgs/southWall.xpm
WE ./imgs/westWall.xpm
EA ./imgs/eastWall.xpm

F 100,100,100
C 53,180,220

1111111
1101001
1011101
101N101
1110101
1000001
1111111