NO ./imgs/northWall.xpm
SO ./imgs/southWall.xpm
WE ./imgs/westWall.xpm
EA ./imgs/eastWall.xpm

F  100,100,100
C  53,180,220

    11111111111111111111111111111
1111100000000000000000D0W00000001
100010010010010011D101100100100111111
10000000000000000000000000000000000001
100000000000000000000000000000000000001
100000000000000000000000000000000000001
100000000000000000000000000000000000001
1000000000000000001D1000000000001111111
111100000000000000D0D00000000001
    1111111111111111111111111111