NO ./imgs/northWall.xpm
SO ./imgs/southWall.xpm
WE ./imgs/westWall.xpm
EA ./imgs/eastWall.xpm

F 100,100,100
C 53,180,220

11111111
10000001
10010001
10010111
10000001
10010111
10010001
100S0001
10000001
10000011
10000001
10000001
10000001
10000001
10000001
10000001
11111111





