NO ./imgs/northWall.xpm
SO ./imgs/southWall.xpm
WE ./imgs/westWall.xpm
EA ./imgs/eastWall.xpm

F  100,100,100
C  53,180,220

    111111111111
1111100000000001
10000000000000111111
100M000000000W0000001
10000000000000111111
100000000000001
111111111111111