NO ./imgs/northWall.xpm
SO ./imgs/southWall.xpm
WE ./imgs/westWall.xpm
EA ./imgs/eastWall.xpm

F 100,100,100
C 53,180,220

1111111
1101001
100S101
1010101
1110101
1000001
1110111
 11011
 11011
 11011
 11011
 11011
 11011
 11111