NO ./imgs/nW.xpm
SO ./imgs/sW.xpm
WE ./imgs/wW.xpm
EA ./imgs/eW.xpm

C 12,5,0
F 30,5,5

               1
              101
             11D11
            1000001
           1000S0001
     111111000000000111111
     100000001000000000001
     1000010010001D1000001
     10001D10100010D000001
     100011001000101110001
      101 10000000001 101
     100011000101000110001
 1111000000000101000000000111111
1000000000000010101D1000000000001
 1111000000000101000000000111111
     100000000000000000001
      1000000010100000001
       10000001010000001
        100000101000001
         1000010100001
          10001010001
          10001010001
          10001010001
           100000001
            1000001
             10001
              101
               1

