NO ./imgs/northWall.xpm
SO ./imgs/southWall.xpm
WE ./imgs/westWall.xpm
EA ./imgs/eastWall.xpm

F  100,100,100
C  53,180,220

111111111111111111
1S0000000000000001
100000000000000001
100010001001000001
100001010000000001
100000100000000001
100000000000000001
100000010000000001
100001000000000001
100010000000001001
100010000000010001
100100000000000001
100000000000000001
100000000001000001
100000000000000001
100000000000000001
100000000000000001
111111111111111111