NO ./imgs/northWall.xpm
SO ./imgs/southWall.xpm
WE ./imgs/westWall.xpm
EA ./imgs/eastWall.xpm

F 100,100,100
C 53,180,220

1111111     1111111
1000001     1000001
1000001111111000001
100N000000000000001
1000001111111000001
1000001     1000001
1111111     1111111





