NO ./imgs/northWall.xpm
SO ./imgs/southWall.xpm
WE ./imgs/westWall.xpm
EA ./imgs/eastWall.xpm

F 100,100,100
C 53,180,220

1111111111111111
1000000000000001
1000000000010001
1000000000001001
1000000000000101
10000000N0000011
1000000000000001
1000000010000001
1000000010000001
1000000010000001
1111111111111111





