NO ./imgs/northWall.xpm
SO ./imgs/southWall.xpm
WE ./imgs/westWall.xpm
EA ./imgs/eastWall.xpm

F  100,100,100
C  53,180,220

    11111111111111111111111111111
111110000000000000000000000000001
100010010010010011D100100100100111111
100M00000000000000000000000000W0000001
1000000000000000000000000000000111111
10000000000000000000000000000001
11111111111111111111111111111111