NO ./imgs/northWall.xpm
SO ./imgs/southWall.xpm
WE ./imgs/westWall.xpm
EA ./imgs/eastWall.xpm

F  100,100,100
C  53,180,220

    1111111111111111111111111111111111111111111111111111
11111000000000000000000000000000000000000000000000000001
100010010010010011D1D110010000000000000000000000000000111111
100M000000000000000000000000000000000000000000000000000000001
1E0000000000000000000000000000000000000000000000000000111111
1000000000000000000000000000000000000000000000000000001
1111111111111111111111111111111111111111111111111111111