SO ./imgs/southWall.xpm
WE ./imgs/westWall.xpm

NO ./imgs/northWall.xpm
C 53,180,220
EA ./imgs/eastWall.xpm
F 100,100,100

               1
              1N1
             10001
            1000001
           100000001
     111111000000000111111
     100000000000000000001
     100000000000000000001
     100000000000000000001
     100011000000000110001
      101 10000000001 101
     100011000000000110001
 1111000000000000000000000111111
100000000000000000000000000000001
 1111000000000000000000000111111
     100000000000000000001
      1000000000000000001
       10000000000000001
        100000000000001
         1000000000001
          10000000001
          10000000001
          10000000001
           100000001
            1000001
             10001
              101
               1

