NO ./imgs/northWall.xpm
SO ./imgs/southWall.xpm
WE ./imgs/westWall.xpm
EA ./imgs/eastWall.xpm

C 53,180,220
F 100,100,100

               1
              101
             10001
            1000001
           1000N0001
     111111000000000111111
     100000001000100000001
     100000001000100000001
     100000001000100000001
     100011001000100110001
      101 10000000001 101
     100011000101000110001
 1111000000000101000000000111111
100000000000001010000000000000001
 1111000000000101000000000111111
     100000000000000000001
      1000000010100000001
       10000001010000001
        100000101000001
         1000010100001
          10001010001
          10001010001
          10001010001
           100000001
            1000001
             10001
              101
               1

